
  ______  __    __    ______     ______        _______. _______         _______. __    __   __  .______   
 /      ||  |  |  |  /  __  \   /  __  \      /       ||   ____|       /       ||  |  |  | |  | |   _  \  
|  ,----'|  |__|  | |  |  |  | |  |  |  |    |   (----`|  |__         |   (----`|  |__|  | |  | |  |_)  | 
|  |     |   __   | |  |  |  | |  |  |  |     \   \    |   __|         \   \    |   __   | |  | |   ___/  
|  `----.|  |  |  | |  `--'  | |  `--'  | .----)   |   |  |____    .----)   |   |  |  |  | |  | |  |      
 \______||__|  |__|  \______/   \______/  |_______/    |_______|   |_______/    |__|  |__| |__| | _|      

