
.______       _______   ______  _______  __  .______   .___________.    _______.
|   _  \     |   ____| /      ||   ____||  | |   _  \  |           |   /       |
|  |_)  |    |  |__   |  ,----'|  |__   |  | |  |_)  | `---|  |----`  |   (----`
|      /     |   __|  |  |     |   __|  |  | |   ___/      |  |        \   \    
|  |\  \----.|  |____ |  `----.|  |____ |  | |  |          |  |    .----)   |   
| _| `._____||_______| \______||_______||__| | _|          |__|    |_______/    
                                                                                
